000111222
000011122
031112222
033445555
333444455
333444555
666678888
667777788
666777888
.941...8.
6.8.5....
...6.5...
...5.3...
....1..94
.........
15.......
.....7...
.......4.
