000111222
000111122
030112222
033444555
333445555
333444458
666777858
667777888
666677888
.........
.........
.........
.........
.........
.........
.........
.........
.........
